filename, language, CSS, comment, blank, total
admin\adminMain.css, CSS, 46, 0, 11, 57
bootstrap\bootstrap-grid.css, CSS, 3511, 7, 201, 3719
bootstrap\bootstrap-grid.min.css, CSS, 1, 6, 0, 7
bootstrap\bootstrap-reboot.css, CSS, 267, 8, 56, 331
bootstrap\bootstrap-reboot.min.css, CSS, 1, 7, 0, 8
bootstrap\bootstrap.css, CSS, 8832, 7, 1199, 10038
bootstrap\bootstrap.min.css, CSS, 1, 6, 0, 7
event\add-forms.css, CSS, 120, 0, 19, 139
event\agenda.css, CSS, 133, 0, 21, 154
login.css, CSS, 303, 22, 77, 402
main.css, CSS, 104, 0, 13, 117
nav.css, CSS, 88, 0, 16, 104
util.css, CSS, 2824, 71, 99, 2994
Total, -, 16231, 134, 1712, 18077